24 
38
......*.......................*.......
......*..***************...*..*..*....
...**.*................*...*..*..*....
...******************..*...*..*.......
.......................*...*..****....
...***************..*..*...*.......*..
......*................*...*..*..*.*..
********************...*...*..*..*.*..
.......................*...*..*..*.*..
....********************......*..*.**.
..............................*..*..*.
******************************...*..*.
.................................*..*.
...*******************************..*.
.................................*..*.
******************************...*..*.
.................................*..*.
....******************************..*.
........................*...*.......*.
.************************...*....*..*.
...*....**.....*..*..*......*....*..*.
.....**....***..............*....*..*.
************************.........***..
...........*..............****........
